 CUBAS
  List<List<int>> _mapDefinition = [
    [1, 1, 1, 1, 1, 1, 1, 1, 1, 1, 1, 1, 1, 1, 1],
    [1, 0, 2, 0, 0, 0, 0, 0, 0, 0, 0, 0, 0, 3, 1],
    [1, 0, 1, 1, 1, 1, 1, 1, 1, 1, 1, 1, 1, 0, 1],
    [1, 0, 1, 3, 0, 0, 0, 0, 0, 0, 0, 0, 0, 0, 1],
    [1, 0, 1, 0, 1, 1, 1, 1, 1, 1, 1, 1, 1, 0, 1],
    [1, 0, 1, 0, 1, 0, 0, 0, 0, 0, 0, 0, 0, 0, 1],
    [1, 0, 1, 0, 1, 0, 1, 1, 1, 1, 0, 1, 1, 0, 1],
    [1, 0, 1, 0, 1, 0, 1, 1, 1, 1, 0, 1, 1, 0, 1],
    [1, 0, 1, 0, 1, 0, 1, 1, 1, 1, 0, 1, 1, 0, 1],
    [1, 3, 0, 0, 0, 0, 0, 0, 0, 0, 0, 0, 0, 3, 1],
    [1, 3, 0, 0, 0, 0, 0, 0, 0, 0, 0, 0, 0, 3, 1],
    [1, 0, 1, 0, 1, 0, 1, 1, 1, 1, 0, 1, 1, 0, 1],
    [1, 3, 0, 0, 0, 0, 0, 0, 0, 0, 0, 0, 0, 3, 1],
    [1, 3, 0, 0, 0, 0, 0, 0, 0, 0, 0, 0, 0, 3, 1],
    [1, 0, 1, 1, 1, 1, 1, 1, 1, 1, 1, 1, 1, 1, 1],
    [1, 3, 0, 0, 0, 0, 0, 0, 0, 0, 0, 0, 0, 3, 1],
    [1, 0, 1, 1, 1, 1, 1, 1, 1, 1, 1, 1, 1, 1, 1],
  ];

Lucas Bressanin
  List<List<int>> _mapDefinition = [
    [1, 1, 1, 1, 1, 1, 1, 1, 1, 1, 1, 1, 1, 1, 1],
    [1, 0, 0, 1, 0, 0, 0, 0, 0, 0, 0, 1, 0, 0, 1],
    [1, 0, 1, 1, 0, 1, 1, 1, 1, 1, 0, 1, 1, 0, 1],
    [1, 0, 0, 0, 0, 0, 0, 0, 0, 0, 0, 0, 0, 0, 1],
    [1, 1, 1, 0, 0, 1, 1, 0, 1, 1, 0, 0, 1, 1, 1],
    [1, 0, 0, 0, 0, 1, 0, 0, 0, 1, 0, 0, 0, 0, 1],
    [1, 0, 0, 0, 0, 1, 0, 0, 0, 1, 0, 0, 0, 0, 1],
    [1, 0, 1, 1, 0, 1, 1, 1, 1, 1, 0, 1, 1, 0, 1],
    [1, 0, 1, 1, 0, 0, 0, 1, 0, 0, 0, 1, 1, 0, 1],
    [1, 0, 0, 0, 0, 1, 0, 0, 0, 1, 0, 0, 0, 0, 1],
    [1, 0, 1, 1, 1, 1, 1, 0, 1, 1, 1, 1, 1, 0, 1],
    [1, 0, 0, 0, 0, 1, 0, 0, 1, 0, 0, 0, 1, 0, 1],
    [1, 1, 0, 1, 0, 1, 0, 0, 1, 0, 1, 0, 1, 0, 1],
    [1, 0, 0, 0, 0, 1, 0, 0, 1, 0, 1, 0, 1, 0, 1],
    [1, 0, 1, 0, 1, 1, 1, 0, 0, 0, 0, 0, 0, 0, 1],
    [1, 0, 1, 0, 0, 0, 1, 0, 1, 0, 1, 0, 1, 0, 1],
    [1, 0, 0, 0, 1, 0, 0, 0, 0, 0, 0, 0, 0, 0, 1],
    [1, 1, 1, 1, 1, 1, 1, 1, 1, 1, 1, 1, 1, 1, 1],
  ];

  Joao Pedro Ramos

 List<List<int>> _mapDefinition = [
    [1, 1, 1, 1, 1, 1, 1, 1, 1, 1, 1, 1, 1, 1, 1],
    [1, 0, 2, 0, 0, 0, 1, 1, 0, 0, 0, 0, 0, 0, 1],
    [1, 0, 0, 0, 0, 0, 0,0, 0, 1, 0, 1, 1, 0, 1],
    [1, 0, 1, 0, 0, 1, 1, 1, 1, 0, 0, 0, 0, 0, 1],
    [1, 0, 0, 0, 0, 0, 0, 0, 0, 0, 0, 0, 0, 0, 1],
    [1, 0, 1, 0, 1, 0, 0, 0, 1, 0, 1, 1, 0, 0, 1],
    [1, 0, 1, 0, 1, 0, 1, 0, 1, 0, 0, 0, 0, 0, 1],
    [1, 0, 1, 0, 1, 0, 1, 0, 0, 0, 0, 0, 1, 0, 1],
    [1, 0, 1, 0, 1, 0, 1, 1, 1, 0, 1, 0, 1, 0, 1],
    [1, 0, 0, 0, 0, 0, 0, 0, 0, 0, 0, 0, 0, 0, 1],
    [1, 0, 0, 0, 0, 0, 0, 0, 0, 0, 0, 0, 1, 1, 1],
    [1, 0, 1, 0, 1, 0, 1, 1, 1, 1, 0, 1, 1, 0, 1],
    [1, 0, 0, 0, 0, 0, 0, 0, 0, 0, 0, 0, 0, 0, 1],
    [1, 0, 0, 0, 0, 0, 0, 0, 0, 0, 1, 0, 0, 0, 1],
    [1, 0, 1, 1, 1, 0, 0, 0, 0, 0, 1, 1, 0,0 , 1],
    [1, 0, 0, 0, 1, 0, 0, 0, 0, 0, 0, 0, 0, 0, 1],
    [1, 1, 1, 1, 1, 1, 1, 1, 1, 1, 1, 1, 1, 1, 1],
  ];